NO textures/ancientstone.xpm
SO textures/brick.xpm
EA textures/yellowstone.xpm
WE textures/greystone.xpm

C 146,141,244
F 136,46,45

111111
100001
11D111
100001
10N001
111111
